25 13 100
   *                     
######H######            
      H---------    +    
      H    ####H   #####H
      H    ####H        H
    % H    ####H  *   % H
##H####    #########H####
  H          +      H    
###########H########H    
       *   H--------H *  
    H#######        ####H
    H    @    *         H
#########################