30 14 200
                              
#####               #####H####
    ##             ##    H    
     ##           ##     H    
+   % ##         ##   %  H    
##H######## * ######H####H####
  H       ##H##     H  %      
  H *      #H#     #H#####H###
H####H                    H   
H    H     %        *     H   
H    H#########H##########H##H
H              H             H
H           @  H            %H
##############################
