25 15 -1
#########################
    -----------------   
   +    H            *   
#####   H           #####
#       H               #
#       H               #
     H# H         #H     
#    H#############H     
#    H             H     
     H             H     
     H*#         #*H     
###H####         ###H####
   H                H    
   H  @             H    
##########################


                         
