28 16 60
      *      *              
H###############H       H   
H            *  H-------H+  
#######H#########       H###
#######H                H   
###### H----------H     H   
#####             H% *  H  *
####         H##########H###
###          H          H   
             H          H   
%            H----------H  *
H############H    %*    H###
H            H  ######  H   
H            H          H   
H    @       H       *  H   
############################
