28 14 -1
      *      *              
H###############H       H   
H            *  H-------H  *
#########H#######       H###
########HH              H   
#######HH---------H     H   
######HH          H  *  H  *
#####HH      H##########H###
#####H       H          H   
     H       H          H   
     H       H----------H  *
H####H#######H    *     H###
H            H  ######  H   
H            H          H   
H    @       H       *  H   
############################